########################################
#        *   .   *   .   *   .         #
#              Emberfall               #
#        *   .   *   .   *   .         #
#                                      #
#              / \                     #
#             /   \                    #
#            /     \                   #
#           /  |~|  \                  #
#          /   |~|   \                 #
#         /    |~|    \                #
#        /     |~|     \               #
#       /      |~|      \              #
#      /       |~|       \             #
#     /        |~|        \            #
#    /         |~|         \           #
#   /          |~|          \          #
#  /           |~|           \         #
# *   .   *   .   *   .   *   .        #
########################################