########################################
#      []      []      []      []      #
#           Oakheart Village           #
#      []      []      []      []      #
#                                      #
#                /|\                   #
#               / | \                  #
#              /  |  \                 #
#             /   |   \                #
#            /    |    \               #
#           /     |     \              #
#          /      |      \             #
#         /      ( )      \            #
#        /      (   )      \           #
#       /      (     )      \          #
#      /      (       )      \         #
#     /      (         )      \        #
#    /      (           )      \       #
#   /      (             )      \      #
#  /      (               )      \     #
#      []      []      []      []      #
########################################