########################################
#   /\    *   /\      /\   *   /\      #
#  /  \  / \ /  \    /  \ / \ /  \     #
# *    *    *    *  *    *    *    *   #
#      /\        /\      /\        /\  #
#     /  \      /  \    /  \      /  \ #
# *      *  *      *  *      *  *      #
#   /\      /\   *   /\      /\   *    #
#  /  \    /  \ / \ /  \    /  \ / \   #
# *    *  *    *    *    *  *    *     #
#      /\        /\      /\        /\  #
#     /  \      /  \    /  \      / \  #
# *      *  *      *  *      *  *      #
#            Crystal Cavern            #
# *      *  *      *  *      *  *      #
#      /\        /\      /\        /\  #
#     /  \      /  \    /  \      / \  #
# *    *  *    *    *    *  *    *     #
#   /\      /\   *   /\      /\   *    #
#  /  \    /  \ / \ /  \    /  \ / \   #
########################################