########################################
#    *      *     *   *      *         #
#         Frost Creek                  #
#    *      *     *   *      *         #
#                                      #
#      ~~~~~~~~\                       #
#     /         \~~~~~                 #
#    /   *   *    \    \               #
#   /             \~~~~~\              #
#  /   ~~~~~~      \    \              #
# /  /      \~~~~~  \    \             #
#    *   *     *   *     *             #
#     /~~~~~\      /~~~~~\             #
#    /      \~~~~~/      \             #
#   /   *   *    /   *   \             #
#  /~~~~~~~~~~~~/         \            #
# *      *     *   *      *            #
#                                      #
#    *      *     *   *      *         #
########################################
