########################################
#      ^      ^   ^      ^      ^      #
#     / \    / \ / \    / \    / \     #
#    /   \  /   |   \  /   \  /   \    #
#            Ironfang Pass             #
#                                      #
#  . . . . . . . . . . . . . . . . .   #
#   ^      ^   ^      ^      ^      ^  #
#  / \    / \ / \    / \    / \    / \ #
# /   \  /   |   \  /   \  /   \  /   \#
#  . . . . . . . . . . . . . . . . .   #
#                                      #
#      ^      ^   ^      ^      ^      #
#     / \    / \ / \    / \    / \     #
#    /   \  /   |   \  /   \  /   \    #
#  . . . . . . . . . . . . . . . . .   #
#                                      #
#      ^      ^   ^      ^      ^      #
#     / \    / \ / \    / \    / \     #
#    /   \  /   |   \  /   \  /   \    #
########################################